19 25
+-------+-------+-+
|       |       | |
| +---+ +---+ + | |
|     | |     | | |
+---+ | + +-+ | | |
|     |   |   | | |
| +-+ +-+-+ +-+ + |
| | | | | | |     |
| | +-+ | +-+ +-+ |
| | |   |     |   |
| + | + +---+-+ + |
|   | |     |   | |
| +-+ | +---+---+ |
|     | |         |
+-+---+ | +---+ + |
| |     | |     | |
| | +---+ | +---+-+
| |       |       |
| +---+ +-+-+ +-+ |
|     |   | | | | |
| +-+ | + | +-+ | |
|   | | | |     | |
+-+ | + | + +---+ |
|   |   |   |     |
+---+---+---+-----+



------------------|
|       |       | |
- ----- ----- - - |
|     | |     | | |
----- - - --- - - |
|     |   |   | | |
- --- ----- --- - |
| | | | | | |     |
- - --- - --- --- |
| | |   |     |   |
- - - - ------- - |
|   | |     |   | |
- --- - --------- |
|     | |         |
------- - ----- - |
| |     | |     | |
- - ----- - ------|
| |       |       |
- ----- ----- --- |
|     |   | | | | |
- --- - - - --- - |
|   | | | |     | |
--- - - - - ----- |
|   |   |   |     |
------------------ 
