41 17
+---+---+---+---+---+---+---+---+---+---+
|   |   |   |   |       |   |   |   |   | 
| +-+ +-+ + | +-+ +-+ + | +-+ +-+ + +-+ |
|   |   | | |     |   | |     |   |   | |
| +-+-+ | | +-+ +-+-+ | +-+ +-+ +-+-+ +-+
| |   | | |   |     | |   | |   | | |   |
| | +-+ +-+ +-+ +-+ | | +-+ | +-+ | +-+ |
| |     |   |   | | | |   | |   | |   | |
| +-+ +-+-+ | +-+ | | +-+ | +-+ | +-+ | |
| |       | |   | | |   | |   | |   | | |
| | +---+ | +-+ +-+ | +-+ +-+ | +-+ | | |
| | |     |   |     |   |   | |   | | | |
| +-+ + +-+-+ | +-+-+ | +-+ + | +-+ | | |
|     |       |   |   |   |   |   | | | |
| +-+ +-+ +-+ + +-+ +-+ | +-+ + +-+ | + |
|   |   |   |   |   |   |   |   |   |   |
+---+---+---+---+---+---+---+---+---+---+